10 20
1 1 1 1 1 1 1 1 1 1 1 1 1 1 1 1 1 1 1 1
1 2 0 9 9 9 7 6 0 0 8 8 0 0 0 0 7 6 3 1
1 9 0 0 0 0 7 6 0 0 0 0 0 0 0 0 7 6 6 1
1 0 0 0 0 0 7 6 0 0 0 0 0 0 0 0 7 7 7 1
1 0 0 0 0 0 7 6 0 0 0 0 0 0 0 0 0 0 0 1
1 0 0 0 0 0 7 6 0 0 6 6 6 0 0 6 6 6 6 1
1 0 0 0 0 0 7 6 0 0 6 5 6 0 0 6 6 6 6 1
1 0 0 0 0 0 7 6 0 0 6 6 6 0 0 6 6 4 6 1
1 8 8 8 8 0 7 6 0 0 0 0 0 0 0 6 6 9 6 1
1 1 1 1 1 1 1 1 1 1 1 1 1 1 1 1 1 1 1 1